Chirurgie maxilo-faciala - curs - PROF. DR. ALEXANDRU BUCUR
Chirurgie maxilo-faciala - curs - PROF. DR. ALEXANDRU BUCUR
1984 - O mie noua sute optzeci si patru - GEORGE ORWELL
Entropie, Volatilitate. Entropy, Volatility - N/A
Chestionare pentru obtinerea permisului de conducere auto - Categoria B - N/A
How To - Cum Sa - RANDALL MUNROE
Hitler si petrolul prahovean - VASILE VIRGIL COMAN
Intre doua lumi - Clujul in carti postale 1918-1945 - RADU LUPESCU
Despre perceptia spatiului in arhitectura - DANA POP
Invata cum sa-ti ingrijesti profund sufletul in 21 de zile - CHERYL RICHARDSON
Privind inapoi cu deferenta - TEODOR DIMA
Explorari in teologie - Spiritul si institutia - HANS URS VON BALTHASAR
Legatul - Principala dispozitie cuprinsa in testament - DIANA-GEANINA IONAS
Sfintii Parinti despre Pocainta - ADRIAN TANASESCU-VLAS
Orasul minciunilor. Dragoste, sex si moarte la Teheran - RAMITA NAVAI
Patinele de argint - MARY-ELISABETH MAPES DODGE
Romania Mare - un ideal implinit - EUGEN STANESCU
Integrama carnaval - Nr. 67 - N/A
Revista - Terapie de basm nr. 7 - N/A
Pacatele fiului - Cartea a doua - THEO ANGHEL
Bach - Inventiuni la doua voci (pentru pian) - JOHANN SEBASTIAN BACH
Plotin. Despre destin - DAN TOMULET
Bulgaria - Litoralul - TOMA RITNER
Limba si literatura romana - Manual pentru studentii straini din anul pregatitor - CRISTINA VALENTINA
Calendarele poporului roman - Februarie - ANTOANETA OLTEANU
Cum gandeste lumea. O istorie globala a filosofiei - JULIAN BAGGINI
1, 2, 3, construiesc in Minecraft - DAVID PLUMEL
Totul despre Cassidy - Vedeta reporter - TAMSYN MURRAY
Mancaruri delicioase pentru toti - MARTHA STEWART
Credinta niceana - Vol 2 - JOHN BEHR
Pneumologie si terapie intesiva - Harrison - JOSEPH LOSCALZO
Scenes sentimentales nr. 3 & 5 - Elegie, Petite fantaisie romantique - EUGENE YSAYE
Aventura cartii - N/A
Saga Daringham Hall: Mostenirea - Partea 1 - KATHRYN TAYLOR
Jocuri distractive pentru timpul liber - Verde - IOANA SUILEA
Re de Dacia - un proiect de la sfarsitul Evului Mediu - IOAN AUREL POP
Profesorul meu semaforul! - N/A
Idolul si Ion Anapoda - Domnisoara Nastasia - GEORGE MIHAIL ZAMFIRESCU
Arta comunicarii - Dezvoltare personala pentru copii - NATASHA DANIELS
Modificari aduse de DOOM3. Sinteze si exercitii - Partea I - OANA DESPA
Lemnuci - Lumea Viselor - A.G. SAGA
Istoria filosofiei contemporane - Volumul II - P. P. NEGULESCU
Credo - Simbolul apostolic explicat oamenilor din zilele noastre - HANS KUNG
Meridianul balcanic - GISELE VANHESE
Puhoaiele primaverii - ERNEST HEMINGWAY
Recunoasteti animalele de la ferma. Cocosul - N/A
La inceput era cuvantul - Meditatii evanghelice duminicale, Volumul I - DIMITRIE BALAUR
Iubeste-te pe tine insuti si vindeca-ti viata - LOUISE L. HAY
Romanul japonez in secolul al XX-lea - FLORINA ILIS
Micuta carte a marilor intrebari - Ce-ar fi daca - RENATA LIWSKA
Portretul lui Dorel Grei - CORNEL UDREA
Geografie. Caiet de lucru pentru clasa a IV-a - Semestrul al II-lea - IONUT POPA
Craciunul in padurea troienita - Aldo si banda de talhari - ASTRID MOLA
Iti multumesc pentru bunatate - N/A
Detectivii de la Marea Nordului - Hoti sub acoperire - BETTINA GOSCHL
Caiet de jocuri si activitati pentru copii isteti - Grupa mare - PASCALE GENESTINE
Tilda Soricela - De-a v-ati ascunselea la petrecerea de vara - ANDREAS H. SCHMACHTL
Muzica populara romaneasca. Volumul V - Din Maramures - BELA BARTOK
Teoria muzicii - Volumul II - DRAGOS ALEXANDRESCU
Zile - Florin Mitroi - ERWIN KESSLER
Limba si literatura romana - Manual pentru studentii straini din anul pregatitor - CRISTINA VALENTINA
Calendarele poporului roman - Februarie - ANTOANETA OLTEANU
Cum gandeste lumea. O istorie globala a filosofiei - JULIAN BAGGINI
1, 2, 3, construiesc in Minecraft - DAVID PLUMEL
Totul despre Cassidy - Vedeta reporter - TAMSYN MURRAY
Credinta niceana - Vol 2 - JOHN BEHR
Pneumologie si terapie intesiva - Harrison - JOSEPH LOSCALZO
Scenes sentimentales nr. 3 & 5 - Elegie, Petite fantaisie romantique - EUGENE YSAYE
Saga Daringham Hall: Mostenirea - Partea 1 - KATHRYN TAYLOR
Jocuri distractive pentru timpul liber - Verde - IOANA SUILEA
Re de Dacia - un proiect de la sfarsitul Evului Mediu - IOAN AUREL POP
Idolul si Ion Anapoda - Domnisoara Nastasia - GEORGE MIHAIL ZAMFIRESCU
Arta comunicarii - Dezvoltare personala pentru copii - NATASHA DANIELS
Modificari aduse de DOOM3. Sinteze si exercitii - Partea I - OANA DESPA
Credo - Simbolul apostolic explicat oamenilor din zilele noastre - HANS KUNG
Puhoaiele primaverii - ERNEST HEMINGWAY
La inceput era cuvantul - Meditatii evanghelice duminicale, Volumul I - DIMITRIE BALAUR
Iubeste-te pe tine insuti si vindeca-ti viata - LOUISE L. HAY
Romanul japonez in secolul al XX-lea - FLORINA ILIS
Micuta carte a marilor intrebari - Ce-ar fi daca - RENATA LIWSKA
Portretul lui Dorel Grei - CORNEL UDREA
Geografie. Caiet de lucru pentru clasa a IV-a - Semestrul al II-lea - IONUT POPA
Craciunul in padurea troienita - Aldo si banda de talhari - ASTRID MOLA
Detectivii de la Marea Nordului - Hoti sub acoperire - BETTINA GOSCHL
Caiet de jocuri si activitati pentru copii isteti - Grupa mare - PASCALE GENESTINE
Tilda Soricela - De-a v-ati ascunselea la petrecerea de vara - ANDREAS H. SCHMACHTL
Muzica populara romaneasca. Volumul V - Din Maramures - BELA BARTOK
Drept penal - Partea speciala conform codului penal - GHEORGHE IVAN
Performanta sub stres - VIOREL COJOCARU
Atlas cu animale - cu 80 abtibilduri - SUSAETA
The Real Regina Maria - Povestea unui suflet - IOANA-NICOLETA GAUREAN
Raiurile si Iadurile mintii - Cunoasterea - IMRE VALLYON
Teodora - Actrita, imparateasa, sfanta - DAVID POTTER
Cuceritorii. Calea regala - ANDRE MALRAUX
Cand bunicul era nepot... - AURELIU BUSUIOC
Performanta grupurilor. Modele de analiza - IOANA VIASU
Pantofarul si moartea - PETER JAMES
Drept penal - Partea generala - ALEXANDRU BOROI
Padurea - Activitati si abtibilduri - ROBERTA MARCOLIN
Teste rezolvate pentru examenul de titularizare - Istorie - ANCA ELENA RUSU
Oana Pellea - Jurnal 2003 - 2009 - OANA PELLEA
Alege Fericirea - Cum sa iti schimbi viata - OANA PUSTIU
Odiseea - Odisseias - HOMER
Terapii sinergice si complementare - Vindecarea anxietatii - ALINA ROBU
Atitudinea - Superputerea ta - EDUARDO CLEMENTE
Oul Micului Bufnita - DEBI GLIORI
Richard Clayderman - Music of love - RICHARD CLAYDERMAN
Amurg - Zori de zi - STEPHENIE MEYER
Despre doliu - Un an din viata lui Leon W. - MIRCEA MIHAIES
Contabilitatea pentru incepatori - Aplicatii practice - VLAD MARIANA
Parintele Arsenie Boca - 1910-1989 - FLORIN DUTU
Istoria. Din zorii civilizatiei pana in zilele noastre - ADAM HART-DAVIS
Animalele - Volumul 1 - TUDOR COZARI
Primul meu dictionar englez - roman - LAROUSSE
Istoria filosofiei contemporane - Volumul III - P.P. NEGULESCU
Unchiul Oswald - ROALD DAHL
Apologie si randuiala - SFANTUL IERONIM
Dorinte de unicorn - SOPHIE KINSELLA
Primul Razboi Mondial - Intre realitate si fictiune - GABRIELA GIRMACEA
Veverita Tremurici - Isi gaseste un prieten - MELANIE WATT
Bont-tiribont - Sandel - FLORENTIN GHEORGHE-SORESCU
Catelusa care isi dorea sa fie unicorn - BELLA SWIFT
Seductie si triumf. Femei-artist in Romania - ELENA OLARIU
Prima Mea Enciclopedie - Cum Se Face... - LAROUSSE
Hellboy - Volumul 1 - MIKE MIGNOLA
Star defenders: Protectorii Pamantului - AMAR TAMIR
Simion Mehedinti - Teoretician Al Educatiei - LUMINITA DRAGHICESCU
Strategii de suport pentru o alimentatie sanatoasa la adolescenti - RIDDER DENISE
Etnicele: (Auto)identificari etno-culturale in Romania contemporana - MARIN CONSTANTIN
Lena portarita de fotbal - MARIA PARR
Razboiul. O Istorie ilustrata completa - N/A
Gottland - Vinil - MARIUSZ SZCZYGIE≈Å
Revista Secolul 21 - Corpul si vindecatorul sau - N/A
Romanii din Bulgaria, Volumul I - Timoc - EMIL TIRCOMNICU
Viva Regina Maria! - DIANA MANDACHE
Dreptul social al Uniunii Europene in practica - Partea I - CLAUDIA-ANA MOARCAS
Amantele trecutului. Mister - ALEXANDRA GHEORGHE
Esenta fiintei. (Mi)teme si simboluri existentiale eminesciene - MIHAI CIMPOI
Istorie, genocid, etnocid - PETRU URSACHE
Educatia speciala. Ghid metodologic - ALOIS GHERGUT
Regina Americii - Volumul 2 - SIERRA SIMONE
Minecraft: Fantome - Scapa cine poate - HEIKO WOLZ
Cruciada impotriva lui Stefan cel Mare - LIVIU CIMPEANU
Razbunatorii - JOHN CONNOLLY
Colectivizarea - "De bunavoie, da' cu forta" - DANIEL POPA
Violetta - Albumul prieteniei - DISNEY
Hotel Ambos Mundos - VINTILA MIHAILESCU
Alba ca zapada - Carte+CD - N/A
Muzica populara romaneasca. Volumul II - Melodii vocale - BELA BARTOK
Perdele de frig. Voumele. I+II - DANIEL BOZGA
Perdele de frig. Voumele. I+II - DANIEL BOZGA
Cartonase - Emotii in farfurie. De ce mananci cand mananci? - COMAN ANCUTA-FLORENA
Sevilia si Andaluzia - Ghid turistic - DORLING KINDERSLEY
English Grammar Practice 1 - The Noun - ANA-MARIA GHIOC
In umbra lui Kissinger - GREG GARDIN
Iulian N. Vlad Confesiuni pentru istorie - AUREL I. ROGOJAN
Codul fiscal comentat si adnotat cu legislatie secundara si complementara, jurisprudenta si norme metodologice - 2021 - EMILIAN DUCA
Tablitele De Sapun - MIHAI BURACU
Lottie Moon - Misionara care a schimbat China - AMY WHITFIELD
Postmodernismul sau logica culturala a capitalismului tarziu - FREDRIC JAMESON
Recitari in piata publica - Volumul II - DAN C. DAVID
Memorator - Limba franceza - CARMEN VOICULESCU
Drept penal roman. Partea speciala. 2021. - Volumul II - IOANA RUSU
Regatul Sfantului Stefan - Istoria Ungariei Medievale 895-1526 - PAL ENGEL
Drept penal. Partea speciala. Teste-grila 2019 - IOAN-MIRCEA DAVID
Disney Printese - Activitati fermecate - N/A
Povesti de suflet - Prietenul meu - ASTRID DESBORDES
Mitteleuropa periferiilor - CORNEL UNGUREANU
Cetatea literara - Anul 1, nr. 1-12 - CAMIL PETRESCU
Exercitii si teste de gramatica engleza - Timpurile verbale - GIORGIANA GALATEANU-FARNOAGA
Fragmentarium - Fictionale - GORUN MANOLESCU
Noua copilarie - Cum sa ne crestem copiii in lumea digitala - JORDAN SHAPIRO
Facute si nefacute - Vrute si nevrute - Vazute si nevazute - SAL
Set Carte de colorat si stilou cu apa - Safari - N/A
Dictionar roman - latin, latin - roman - ALEXANDRU ANDREI
Cu ce se mananca de fapt Marketingul - ATTILA BIRTHA
Femeia Hopa-Mitica - CRISTINA STAMATE
Boxset Stefanie Stahl - seria Vindecarea copilului interior - STEFANIE STAHL
World to Fantasy - Nu stii tu - TEODOR MORAR
Si frunzele cazand se inaltau - PAULA ROMANESCU
Osme. Antologie de texte pentru nasul oricui - CLAUDIU SFIRSCHI-LAUDAT
Album - Florica Prevenda - N/A
Secretele construirii Marii Piramide din Egipt - IONEL HANTULIE
Albumul cu povesti - IOANA-DANIELA SABAU
Set carte si papusa - Aelia, fetita daca - EVELINA DELIA VADUVA
Jurisprudenta in domeniul TVA - Peste 100 hotarari ale CJUE, Volumele I si II - MIHAELA BENTA
Nepotii Roademultulesei - FLORIAN CRISTESCU
Obolul visului - MARGUERITE YOURCENAR
De vorba cu Valeriu Popa despre sanatate si viata - OVIDIU HARBADA
Bluff - Cacealmaua bancilor centrale si criza economica - ANJUM HODA
Plantele - imagini ale lumii sufletesti - ERNST-MICHAEL KRANICH
Perle pe tarm - IULIA - IARINA IORGA
Ultima cina cu Leonardo - Anula - CORNEL GEORGE POPA
Cartea mea cu jocuri si activitati - Girafe - N/A
Deliberare asupra imnului celor trei tineri - GERARD DE CENAD
Ultimele cazuri ale lui Miss Marple - AGATHA CHRISTIE
AI Act - Viitorul deciziilor noastre - ALIN POPESCU
Steaua fara nume - Nam na jana tara - MIHAIL SEBASTIAN
Scrisoare de la Peles - Una carta de Peles - CORINA FIRUTA
Story Poem - Capitolul 2 - PETRU ILIESU
Revista Secolul 21 - Solomon Marcus II 1-6/2018 - N/A
Comorile muzeelor ruse - N/A
Costache Olareanu - Dincolo si dincoace de biografic - CLAUDIA ENE
Saga - Volumul 1 - BRIAN K. VAUGHAN
Mihai Viteazul - Viata si rolul sau in istoria romanilor - MANOLE NEAGOE
Stefan cel Mare - Intre sange si credinta - IOAN URSU
Neuronie - Neuronia - Editie bilingva - CALIN VLASIE
Almanah estival Rebus de buzunar - 2024 - N/A
Capriciile destinului - Vera Molea in dialog cu regizorul Lucian Giurchescu - VERA MOLEA
Cele Zece Porunci In Secolul Al XXI-Lea - FERNANDO SAVATER
Durerea. Dincolo de teatru - OCTAVIAN SAIU
Irevocabil! Cum l-am invins pe Ceausescu - SORIN DUMITRESCU
Prima mea biblioteca ilustrata (8 carticele). Primele cuvinte - N/A
Razboiul romanesc de eliberare si intregire nationala 1916-1918 - MIRCEA DJUVARA
Ascultati, copii, oare cine poate fi? - N/A
Manual de lupta impotriva francmasoneriei - MARIAN CRACIUN
Transilvania - Starea noastra de veghe - IOAN-AUREL POP
Mierea istoriei - Convorbiri cu Fabian Anton - ZOE DUMITRESCU-BUSULENGA
Conversatii cu Dumnezeu - Volumul IV: Trezirea speciei - NEALE DONALD WALSCH
Puterea povestii - Studiu monografic despre Tudor Dumitru Savu - RENATA ORBAN
Povestile unei motocicliste - SABINA MONICA POPESCU
Enciclopedia auto-sustenabilitatii - Ghidul complet al gospodariei autonome - JAMES STRAWBRIDGE
Identitatea PR-ului contemporan - ELENA PRODAN
Avram Iancu - O viata de erou - SILVIU DRAGOMIR
Yasunari Kawabata - Visarile lumii plutitoare - RODICA FRENETIU
Numere cu rime - Joc educativ - LAVINIA TRIFAN
Aventuri in tabara cu ponei - Sophie si poneiul misterios - OLIVIA TUFFIN
Motanul incaltat - Stiu sa citesc cu litere mari de tipar! - CHARLES PERRAULT
Ghidul Pelerinului - Manastirea Varatec - ZOE DUMITRESCU-BUSULENGA
Mumiile egiptene - multiplan - N/A
Lassie se-ntorce acasa - ERIC KNIGHT
Cartea verii - Vinyl - TOVE JANSSON
Eu am fost spioana care l-a iubit pe Fidel Castro - MARITA LORENZ
O istorie mondiala a comunismului - Volumul 3 - THIERRY WOLTON
Lectii despre viata de apoi - Cei de dincolo abia asteapta sa ne invete - CLAIRE BROAD
Razboiul Crimeei 1854-1856 - JOHN SWEETMAN
Integrama Carnaval - Nr. 68 - N/A
Toate panzele sus! - RADU TUDORAN
Punctul alb si cubul negru / The White dot and the black cube - N/A
Te voi rapi la noapte! - STELIAN TURLEA
Tarot - Trecut, prezent si viitor - SERAPHIN ZAKAI
Legislatia constructiilor - Actualizat la 30.09.2024 - OANA RUXANDRA GHERGHINA
Femeile si economicul. Taramul-Ei. Tapetul Galben - CHARLOTTE PERKINS GILMAN
Inghetata la micul dejun - LAURA JANE WILLIAMS
Societatea procedurala - Elemente de critica a puterii digitale - SORIN BORZA
1984 - O mie noua sute optzeci si patru - GEORGE ORWELL
Ordinul Povestitorilor - Nr. 15 - ADINA POPESCU
Enciclopedia Juridica Romana - Volumul I - A - C - IOSIF R. URS
Actori romani - societari la Comedia Franceza - ANCA COSTA-FORU
Mapa pasari - Cuiburi si alte vietuitoare - N/A
Evreu fara frontiere - Vol. I - TIBERIU ROTH
Noi, romii si restul lumii - ELENA DUMITRESCU-NENTWIG
Dumitru Tepeneag - originalul onirograf - MARIAN VICTOR BUCIU
Etnoculinarul romanesc - Preparate de peste - RADU ANTON ROMAN
Asasinatul lui Kennedy - Sfarsitul unui vis - BILL O'REILLY
Coliba unchiului Tom - Volumul 1 - HARRIET BEECHER STOWE
Iti da cu seen, da-i cu be/was/been - POTECA PE MARE
Vine Craciunul! - MONIKA UTNIK
SIEGO - (Contra)Aventuri din (I)Realitatea Imediata - EMIL STRAINU
Niculae Filipescu. Insemnari (1914 - 1916) - NICOLAE POLIZU-MICSUNESTI
Lucian Blaga - Ipostazele harfei de-ntuneric - GEORGE VULTURESCU
Comert rural: perspectiva integrarii in fluxurile de distributie ale UE - DUMITRU PATRICHE
Montessori acasa - Explorez natura - DELPHINE GILLES COTTE
Midicolorici - Carte de colorat 4-5 ani - LAURENTIU CULEA
Gasca Puisorilor - Misterul de la ferma - DOREEN CRONIN
Poemele - The Poems - ALEXANDRU VLAD
Animale salbatice - LAURA TEODORA RADULESCU
Ai voie, Naivoie! - OLINA ORTIZ
Baudelaire 150 ans - Baudelaire 150 de ani - IOAN POP-CURSEU
Critica ratiunii ecumenice - VLAD MURESAN
Octavian Goga. O viata, un destin - Vol. I+II+III - GHEORGHE I. BODEA
Wundersmith - Chemarea lui Morrigan Crow - JESSICA TOWNSEND
Insulele Mauritius - Ghid turistic - MIHAELA VICTORIA MUNTEANU
Metadrept - Xenodiplomatia spatiala - NASTY MARIAN VLADOIU
Revista Secolul 21 - Nietzsche - Un precursor al secolului XX - N/A
Teatru - Volumul II. Insula. Nopti fara luna. Potopul - MIHAIL SEBASTIAN
Limbajul poetic ‚Äì act creator si actualitate culturala - RODICA FRENTIU
Anul Zero. 1945, o istorie - IAN BURUMA
Invatam sa desenam animale - JO MOON
Biografia lui Iisus. Dupa Evanghelii - GIANFRANCO RAVASI
Perspectivele minoritatii slovace din Romania in contextul migratiei si al provocarilor socio-demografice - CLAUDIA CARDOS
Erebos - Jocul razbunarii - URSULA POZNANSKI
Arbitrajul comercial intern si international. Jurisprudenta adnotata si comentata 2015-2019 - MARIN VOICU
Cum sa devii capitalist cand nu ai niciun capital - NATHAN LATKA
Caderea imparatiilor - STACHECIAN
Atlas geografic Europa - MARIUS LUNGU
Despartit de lume si rugator pentru lume - DIONISIE CONSTANTIN
Slava lui Dumnezeu - O estetica teologica - Volumul V - HANS URS VON BALTHASAR
Cartile micului geniu - Harti si geografie - KEN JENNINGS
Engleza - Ghid de conversatie roman-englez - N/A
Diferente culturale de perceptie a culorilor in Europa si Asia. O perspectiva asupra consumerismului global. - PATRICIA BLAGA
Ce si Cum - Mumii din toata lumea - RENATE GERNER
Viata lui Benvenuto Cellini scrisa de el insusi - BENVENUTO CELLINI
Ghid de conversatie Roman - Francez - ALINA MOMANU
Cincizeci de cuvinte pentru ploaie - ASHA LEMMIE
Raspunsuri la intrebari ale intelectualilor. Volumul I - TEOFAN ZAVORATUL
80 de nimfe-ntr-un dulap - EMIL BRUMARU
Laboratorul de acasa - Experimente - SILVIA OLTEANU
Globul amintirilor - O viata de medic - GENNA MARIA ELIANE
Iubim Basarabia - Articole jurnalistice. Editoriale. Predici. Evocari. - VASILE TEPORDEI
Amritanubhava - Experienta Nemuririi - JNANESHWAR
Ciprian Porumbescu - Mic album pentru pian - CIPRIAN PORUMBESCU
Lectia, o meditatie cu sapte teme - OCTAVIAN SAIU
Anii de gradinita - HEDVIG MONTGOMERY
Ne distram si coloram - Jucarii - N/A
Doua lectii despre Infernul lui Dante - GALILEO GALILEI
Felinarium - ANDREI CRISANT DURAN
Comportamentul alimentar - MARC RUIZ DE MINTEGUIA
Disney Bebe. Primul meu atlas. Animale - N/A
Istoriografia separatismului transnistrean (1989‚Äì2005) - LIDIA PRISAC
Operatiunea Swissleaks - GERARD DAVET
Patru critici literari - Jurnale si memorii - LIANA COZEA
Carte Cu Abtibilduri - Creaturi Mitice - NATASHA REED
Autohipnoza pentru incepatori - PATRICIA D'ANGELI
Literatura romana - acasa - THEODOR CODREANU
55 de povesti de Andersen si Fratii Grimm - Editia II - HANS CHRISTIAN ANDERSEN
Vinul - de la strugure in pahar - JENS PRIEWE
Copilul meu gandeste prea mult - CHRISTEL PETITCOLLIN
Dragonsdale - Calaretii Furtunii - SALAMANDA DRAKE
Fiara - Nevisatorul - Trei - LUMINITA DASCALU
Mat, Ema, Tica si eu in vacanta - Clasa pregatitoare - LAURENTIU CIRSTEA
EKG - Tot ce trebuie sa stii - DR. MALCOLM S. THALER
Cultura romana pe intelesul patriotilor - MIRCEA VASILESCU
Noul cod civil adnotat cu doctrina si jurisprudenta editia a II-a - Vol. I (art. 1-1163) - TERZEA VIOREL
Sandman - Volumul 1 - NEIL GAIMAN
Echilibrul psihic al actorului in actul creatiei - OFELIA MAGDALENA POPII
Familia romaneasca - reper de stabilitate - RALUCA POPESCU
Etica si integritate academica - Provocari pentru organizatiile secolului XXI - VADIM DUMITRASCU
Anatomie pentru miscare - Volumul 1 - BLANDINE CALAIS-GERMAIN
Mutat la tara - Viata fara ceas: Din Londra in Apuseni - ANDY HERTZ
TVA - Jurisprudenta Curtii de Justitie a Uniunii Europene (3 volume) - VIOREL TERZEA
Diavolul - O amagire - DAVID BERLINSKI
Eu n-am trait razboiul - ANCA ZAHARIA
Minoritati Romanesti Sud - Dunarene - EMIL TIRCOMNICU
Viziunea din umbre - Furtuna Dezlantuita - ERIN HUNTER
Managementul conflictelor in organizatii - CLAUDIU COMAN
Calatorie spre centrul infernului - RUXANDRA CESEREANU
Citesc si colorez cu autocolante - Plaiul meu - GRIGORE VIERU
1000 de intrebari si raspunsuri. Al doilea razboi mondial - KIERAN WHITWORTH
Secole De Arta - Sec al XVII-lea - ROSA GIORGI
Admiterea in magistratura si in avocatura. Culegere de subiecte cu explicatii ale variantelor de raspuns - Volum IV - CRISTIAN BALAN
Roar. Calatorie spre tinutul magic - JENNY MCLACHLAN
Manual de utilizare a creierului. Volumul II - L. MICHAEL HALL
Cum pregatim copilul pentru inceperea gradinitei / scolii? - ALINA IOANA CIOCODAN
URSSA - Uniunea Republicilor Sovietice Socialiste ale Americii - SERGIU SOMESAN
Inima zdrobita. Destinul unui tata - VLADIMIR SCERBININ
Social media influencerii si rolul lor publicitar - DELIA CRISTINA BALABAN
Un coltisor de Bucuresti - Cartierul Puisor - EUGENIA ENACHESCU
Bazele psihodinamice ale terapiilor experientiale de grup si de familie - CRISTINA DENISA GODEANU
Tot ceea ce trebuie sa poata barbatul absolut - OLIVER KUHN
Alice in Tara Minunilor - carte de colorat - SIR JOHN TENNIEL
Tu esti Placebo - Meditatia 1 - JOE DISPENZA
Cheia de Aur - Volumul 6 - MOKA
Romania in relatiile internationale (1939-1947). Volumele I+II - DAN VATAMAN
Lumea unicornilor - N/A
Filosofia pe scurt - De la presocratici la Hegel - NICOLAE TURCAN
Avutia religiilor - ROBERT J. BARRO
Despre cum se face o casuta dintr-un mar - OANA LOHAN
Axma - Steaua iubirii eterne - PETRESCU COSTIN PETRY
Dictator, demon, demagog - Intrebari si raspunsuri despre Adolf Hitler - ANNA MARIA SIGMUND
Spiritul Sfant, darul Tatalui si al Fiului - RENZO LAVATORI
Fiara si suveranul - Vol. I (Seminar 2001-2002) - JACQUES DERRIDA
Colorez animale din jungla - N/A
Jurnal de pescar - N/A
Harta imprejurimi Bucuresti - N/A
Planse - Personalitati marcante - N/A
Ajutorul public judiciar in materia taxelor judiciare de timbru - garantie a dreptului de acces la o instanta - VIOREL LIVIU-ALEXANDRU
Cufarul ascetilor - Valea babei - OFELIA MARTIN
Mysterium Christi - Volumul 3 - WILHELM DANCA
Manual de vioara. Volumul IV - Anexa - IONEL GEANTA
Basme - Cenusareasa - GOOL A. VAN
Sufla aerul - Ai grija de planeta ta - NURIA JIMENEZ
Trauma - Slabiciunea Victoriei Bergman Vol. II - ERIK AXL SUND
Ce si Cum - Minerale si roci - WERNER BUGGISCH
Femina - Femei in culisele istoriei - JANINA RAMIREZ
Ferma zgomotoasa - Cei patru purcelusi - LOREDANA DAN
Drumul spre libertate - De la cunoasterea senzoriala la transcunoastere - VASILE STANESCU
Disney Clasic. Jocuri si activitati cu autocolante - N/A
‚ÄûSpune-mi cƒÉ mƒÉ iube»ôti...‚Äù Erich Maria Remarque - Marlene Dietrich - WERNER FULD
Adevarul lui Alcibiade. Despre adevar, iubire si fragilitate umana in filozofia greaca - TEREZA-BRINDUSA PALADE
Fise interdisciplinare pentru clasa a III-a - Activitati integrate - ADINA GRIGORE
Micul autobuz rosu in oras - DORIS EISENBURGER
Culege-ti toamna de pe buzele mele! - STEFAN VERES
Educatia sociala - Sinteze pentru profesori - ION ALBULESCU
Sa cunoastem meseriile - SMARANDA MARIA CIOFLICA
Antologiile Revistei Cultura - Criticii literari 2005-2017 - ANGELA MARTIN
Cultura targovisteana intre mijlocul secolului al XVIII-lea - inceputul secolului al XX-lea - MIHAI OPROIU
Primul meu caiet pentru acordeon - MISU IANCU
Primul meu dictionar Roman-Spaniol - ELENA IONESCU
Baita - Cine face baita? - INESA TAUTU
Palaria Vrajitorului - TOVE JANSSON
Scrierea tacuta, scrierea imposibila - ARINA-CODRUTA NEAGU
Maramures. Tara lemnului/ Le Maramures pays du bois - N/A
Croatia - Ghid turistic - DANA CIOLCA
English confused, abused and misused words - English ‚Äì Romanian Dictionary - CRISTINA BACIU
Canonul si vocile uitate - VICTOR RIZESCU
Pic cu pic invat de mic - Culori si nuante / Colors and Shades (romana - engleza) - N/A
Cronicile din Narnia - Printul Caspian - C.S. LEWIS
Istoria romanilor - De la origini si pana astazi, Volumul II - OVIDIU PECICAN
Drept administrativ - Serviciul public. Proprietatea publica - VASILICA NEGRUT
Inghite Platon, nu Prozac! - LOU MARINOFF
Ghid - Memo Med 2021, editia 27 - DUMITRU DOBRESCU
Carte de exercitii - Hallo Deutsch! Editie Bilingva - SAM HUTCHINSON
Imbunatateste-ti instantaneu dispozitia - OLIVIA REMES
168 de ore - Ai mai mult timp decat crezi - LAURA VANDERKAM
Fenomenologia transpersonala - VLAD BRANESC
D'Artagnan contra Cyrano - Cavalerul misterios - PAUL FEVAL FIUL
Fiti libere acum si aici! - Deveniti feministe - PRIYA BASIL
Business judgment rule - Regula judecatii de afaceri - VASILE SOLTAN
Strategii de dezvoltare durabila a turismului in Tara Barsei - ADINA CAMARDA
Lampa cu led - Bumblebee - PALADONE
Catelusul Ham Ham are masina - N/A
Istoria Holocaustului din Romania - Un manual - TESU SOLOMOVICI
Influenta sociala - Cum sa obtii ce vrei fara compromisuri - ZOE CHANCE
Scoala fricosilor 2 - Lectia nu s-a terminat - GITTY DANESHVARI
Nomazii - Hoinarii care ne-au modelat lumea - ANTHONY SATTIN
Sarbatori si obiceiuri - Rudarii romanofoni din Bulgaria - EMIL TIRCOMNICU
Calatorii identitare. Romanii megiesi - Volumul II - MIHAI NICOLAE
Elena - Portretul unei regine - PRINCIPELE RADU AL ROMANIEI
Spectacolul mintii. Muzica, voce, terapie - LIGIANA M. PETRE
Arta - Istorie - Memorie - patrimoniul cultural national - MARIANA LAZAR
Odiseea manuscriselor Eminescu - Volumul I, II, III - POMPILIU CRACIUNESCU
Dictionar de superstitii. Mari personalitati si superstitiile lor - PIERRE CANNAVAGGIO
Ce se intampla cu mine - pentru fete - SUSAN MEREDITH
Plansa harta lumii A4 fata/verso - N/A
Lupul Moralist - Editie bilingva - N/A
Invatatura despre Sfintele Icoane in teologia ortodoxa romaneasca. Volumul II - N/A
Mr. Clippit and Comp. - SERBAN FOARTA
Spionul si tradatorul - BEN MACINTYRE
Elemente formative greco-latine in limba romana - ALINA GIOROCEANU
Maria - vie printre noi - PIERRE CLAVERIE
Melodii vrajite pentru pian - OCTAVIA POPESCU
Parentingul pasnic - NANCY S. BUCK
Bobo Puidesomn - Piratul - MARKUS OSTERWALDER
O istorie culturala - Cititul - STEVEN ROGER FISCHER
Puii lui Mog - Eu si Mog - JUDITH KERR
Ciudateniile presedintilor americani - JAKOB VAN ERIKSSON
Cand animalutele sunt obosite - SABINE CUNO
Belonging - Stravechiul cod al lui ‚Äûimpreuna‚Äù - OWEN EASTWOOD
Cranii de lemn - ION MOTA
1990 - Vremea in schimbare - LIVIU ANTONESEI
Ghid Turistic - Oltenia de Nord - FLORIN ANDREESCU
Lumea vegetala a Moldovei. Plante cu flori - Partea II - ANDREI NEGRU
Eu gatesc, eu cresc - Montessori - VANESSA TOINET
Unpregnant - O calatorie cu surprize - JENNI HENDRINKS
Dictionarul conflictelor lumii 1945-2019 - VIOREL IRASCU
Miriapodul hoinar - ADINA POPESCU
Pe acest pamant al Polovragiului - DUMITRU BADITA
Secolul 21 - Mariana Celac contemporanul nostru - COLECTIV DE AUTORI
Incursiune in psihopatologie si psihologie clinica - CAMELIA DINDELEGAN
Stelen - Stele - IOAN MILEA
Animale domestice - N/A
Moda - Office Style - N/A
Figurine si ornamente din aluat - PETO AGNES
Adio, zahar! - CARMEL MOLLY
Ferentari incomplet - Politici urbane la o margine de oras 1846-2011 - ANDREI RAZVAN VOINEA
Scrieri - Volumul 2 - A. E. BACONSKY
Bal la contele d‚ÄôOrgel - RAYMOND RADIGUET
Conni si lumea jocurilor 6-7 ani - ROLAND SCHENN
Codul fiscal cu Norme si Codul de procedura fiscala - Iulie 2024 - N/A
Mircea Suciu - Fractura - MIRCEA SUCIU
Neghinita - Basme si alte scrieri - BARBU STEFANESCU DELAVRANCEA
Gr. Dinicu - Ciocarlia si Hora staccato pt. vioara / violoncel si pian - GRIGORAS DINICU
Cultura Kawaii si discursul publicitar japonez - OANA-MARIA BIRLEA
Miezul noptii la Pera Palace - CHARLES KING
Aventuri cu dinozauri - N/A
Viziune si spirit tragic in literatura romana a secolului XX - GABRIEL PETRIC
Scoala de desen - Portrete - ANDRAS SZUNYOGHY
Dreptul social al Uniunii Europene in practica - Partea II - CRISTINA CASIAN
Ferma animalelor - 1984 - GEORGE ORWELL
Scrieri. Cuvente den batrani - Volumul 11 - BOGDAN PETRICEICU HASDEU
Tinerete fara batranete si viata fara de moarte editie bilingva romana-chineza - PETRE ISPIRESCU
Secolul 21 - Chisinau. Dimensiuni culturale - LIVIA SZASZ
Cutia Pandorei. Elada sau Povesti de familie (in cautarea obarsiilor) - Volumul 1 - MIHAIL GALATANU
Estimarea Coordinate - Free - GABRIELA BEGANU
Biblia pierduta: Romanul grafic - Partea a doua - IGOR BERGLER
Cum sa faci fata persoanelor explozive emotional - ALBERT J. BERNSTEIN
Beethoven - Marile epoci creatoare, Volumul II - ROMAIN ROLLAND
Transportul rutier al marfurilor periculoase - ADR - MARIUS TEODORESCU
Album Ciubotaru & Mavrodin - N/A
Erudita pietate - Poeme alese - CEZAR IVANESCU
Bambi - FELIX SALTEN
Un Craciun de neuitat - N/A
Cuvinte cu lipici - Pasare - N/A
Peter Pan - J.M. BARRIE
Invataturile lui Belial - VLAD TUDOSIE
Dosarele Scarlet - Spargatoare la inaltime - TAMSIN COOKE
Harta - Muntii Bihorului - Platoul Padis - N/A
Introducere si comentariu la Sfanta Scriptura. Volumul VI - Cronicile - JOSEPH A. FITZMYER
O istorie in epistole a exilului romanesc - GRIGORE GAFENCU
Baby Book - Povestea ta incepe aici - N/A
Darul desavarsit - Cetatea sub asediu - Pe ce lume traim - TEODOR BACONSCHI
Persepolis - Volumul 2 - MARJANE SATRAPI
Mami - Da, dragoste - ANTOANETA OPRIS
Pestisorul de Aur - FRATII GRIMM
Non-monogamia - Ghidul relatiilor deschise - RHEA ORION
Luca. Silenzio, Bruno! - MEREDITH RUSU
Expertiza contabila si diagnostic financiar - studii de caz - NICOLAE BALTES
Moara cu noroc - Popa Tandra - Budulea taichii - IOAN SLAVICI
Excel 2023 - Curs pentru incepatori - VLAD TUDOR
Caietele restaurarii 2017 - N/A
Secolul coanei Lizica - ZOLTAN ROSTAS
Cele opt batai ale orologiului - MAURICE LEBLANC
Vreau sa stiu - Anotimpurile - PIERRE WINTERS
Secretele machiajului de mireasa - CORINA TUDOR
Sovietizarea Romaniei 1945-1948 - VLADIA MIHAI
Figuri memorabile ale papalitatii - legende si controverse - VLADIMIR DUCA
Pistis Sophia. Cartile I si II - N/A
Slices of Youth - Parte din Tine - LAMBERT BARTHELEMY
Ecuatiile disperarii - Poeme - VALERIU MATEI
P tlkmnd alba ai btn d POWER - Pe Telekomanda alba ai buton de power - O. NIMIGEAN
Clubul Corner Park - Viata secreta a Lolei - DAVINA BELL
Cartea 3D - Deciziile determina destinul - GEORGIANA DRAGAN MOLDOVEANU
Dictionar roman - german - LIVIA WITTNER
Doamne, vindeca-ma de frica! - SILUANA VLAD
Theresa May - Un prim-ministru pentru Brexit - ANTHONY SELDON
Apa - De la ordinea practica la ordinea metafizica - DOINA-CRISTINA MAZARE
Paula invata sa mearga pe bicicleta - Nivelul I - KATJA REIDER
Coloana serpuita - JASON GOODWIN
Muzica din cuvant - De la Bach la Beethoven - ELENA MARIA SORBAN
Sase sasi in sase saci - Manual de dictie - CARMEN IVANOV
Unul - Nu exista decat Unul - GERALD BEN MERZOUG
Viata fara frica - Scrieri esentiale, vol. 3 - BERTRAND RUSSEL
Pistuliili portugjezi - Scrisorile portugheze - MARIANA ALCOFORADO
Metode de a invinge plictiseala la scoala - Volumul 2 - PETE JOHNSON
Fratii Grimm - Basme populare - Basme germane - FRATII GRIMM
Republica Coreea - MARINELA - OANA NEDELEA
Povestile copilariei - Printul fericit - OSCAR WILDE
COVID -19 - DEBORA MACKENZIE
Lumea lui Dodo - Pot sa ma imbrac singur - ADRIENNE HEYMANS
Psihosociologie - Teorii, cercetari, aplicatii - SEPTIMIU CHELCEA
Cartea ceaiului 1921-1925 - OKAKURA KAKUZO
Horoscop 2025 - Ghidul tau astral complet - CLAIRE COMSTOCK-GAY
Interpretarea muzicala. Gandirea specifica - Volumul I + II - CONSTANTIN IONESCU-VOVU
Aventuri in vacanta cu Floppy - Clasa pregatitoare - DORA LAURA VIZITEU
Set de 5 carticele - Cele mai frumoase fabule - La Fontaine - JEAN DE LA FONTAINE
Imparatul - Copil. Povesti in versuri - PETRE CRACIUN
Codul penal si legea pentru punerea in aplicare - Actualizat la 30.09.2024 - VALERIAN CIOCLEI
magie, abur, vis - 3 volume - CATALINA BUZOIANU
Misiunea contelui Czernin in Romania - SORIN CRISTESCU
GM 1 - GM 2 - GILI MOCANU
Pacatele fiului ‚Äì Cartea a patra - THEO ANGHEL
Fabule si vorbe cu talc - N/A
Fructe si legume cu proprietati antiinflamatoare - BEVERLY LYNN BENNETT
Descopera cuvintele misterioase din poveste - Ratusca cea Urata - N/A
Moldova - Coordonate orfice - ANDREEA NECULAI
Fobiile - fricile care ne de/finesc - EUGEN JURCA
Tratat de drept civil - Volumul III - FRANCISC DEAK
Vreme trece, vreme vine - Passe le temps, vient le temps - MIHAI EMINESCU
Bucuresti - Budapesta: Budapesta - Bucuresti - GONCALO M. TAVARES
In vacanta - BROWN WATSON
Coco - ITZIAR MIRANDA
Opus Dei - JOHN L. JR ALLEN
Topografia Tarii Romanesti - CONSTANTIN CARACAS
Kirigami - Idei creative 88 - TERLECZKY ADAM
Portalul Magic - Comoara piratilor - MARY POPE OSBORNE
Dictionar de termeni oficiali - DOF - N/A
Sfarsit de Secol Romanesc - ADRIAN CIUBOTARU
Logo-armonia de acasa. Volumul II - De la parinte, la parinte-terapeut - MADALINA ORIAN
Set - Primele mele povesti - N/A
Culegere de probleme - Armonia numerelor - Clasa a IV-a - MIHAELA SINGER
Calatorii identitare. Romanii megiesi - Volumul I - MIHAI NICOLAE
Scoala memoriei ‚Äì Sighet 2002 - N/A
Sfantul descult ce vine degraba in ajutor - IOAN MAXIMOVICI
Mapa - Pasari sedentare si migratoare - INESA TAUTU
Jocuri logice - Pozitii spatiale - KATRIN MERLE
Cea mai cool gasca din lume - Haos in bucatarie - MAJA LUNDE
Operele lui Spiru Haret Vol. II - Oficiale 1901-1904 - SPIRU HARET
Tifi Papadie - O zi in casa din copac si alte nazdravanii - ANDREAS H. SCHMACHTL
Agent secret in clasa a 6-a - Selfie-urile sunt eterne - MARCUS EMERSON
Romania - 1866-1947 - KEITH HITCHINS
Any si Abi - Vol. 1 - LIDIA DINA COROAMA
Cenusa Angelei - O copilarie irlandeza - FRANK MCCOURT
Cuore - Inima de copil - EDMONDO DE AMICIS
Coloram si ne jucam cu Ingrid, Matei si Pufi. Activitati distractive - Volumul 2 - IOANA CRISTINA VLADOIU
Carticica mea cu jocuri de Craciun - N/A
Canonul (im)perfectiunilor - IOANA PAVEL
Civilizatia romanilor intre medieval si modern orizontul imaginii (1550-1800) - Volumul 2 - RAZVAN THEODORESCU
Luna Noiembrie - Ajutorarea prin rugaciune a celor raposati - FRANCESCO FAA DI BRUNO
Apostolii si primii discipoli ai lui Cristos. La originile Bisericii - JOSEPH RATZINGER
Sub tavalugul istoriei si al religiei. In cautarea libertatii si a identitatii - NICHOLAS KAZAN
Magicul magazin de inghetata - O portie de magie cu sos de ciocolata - HEIKE EVA SCHMIDT
Harta rutiera Spania si Portugalia - N/A
Centura lui Orion - EUGEN POSA
Admiterea in magistratura si in avocatura - Drept penal - CRISTIAN BALAN
Eva - SIMON LIBERATI
Primeste iubirea pe care o doresti - Ghid pentru cupluri - HARVILLE HENDRIX
Regatele Ruinei - Volumul 3 - YORUHASHI
Designul - Intre arta si tehnologie - OCTAVIAN SIMION
Pagini de jurnal. Volumul I (1923-1930) - SIMONA LAHOVARY
Figurine nostime din capace - OLGA GRE
Album Romania - oameni, locuri si istorii. Romana - Engleza - FLORIN ANDREESCU
In competitie cu norocul - CLAYTON M. CHRISTENSEN
Visio Sancti Pavli Apostoli. Apocalipsa lui Pavel - N/A
Capra cu trei iezi - Citim, invatam, coloram, ne jucam! - CALIN MARCELA
Set 4 volume - Romania in Primul Razboi Mondial - PETRU OTU
Coloram cu Ema si Eric - carte de colorat - IOANA CHICET-MACOVEICIUC
Practica judiciara in materie penala - Drept penal. Partea generala - ALEXANDRU BOROI
Duvernoy - Studii elementare op. 176 - J. B. DUVERNOY
Familia Peppei - N/A
Cele sapte paturi ale harciogului - SUSANNA ISERN
Primele 365 de zile din viata unui copil - HELLBRUGGE THEODOR
Eminescu. Ta(Tat) Twam asi - GHEORGHE DOCA
Canonizare, demitizare si realism stiintific - IONUT BUTOI
Povestile copilariei - Lebedele salbatice - HANS CHRISTIAN ANDERSEN
Secolul 21 - Doinas - COLECTIV DE AUTORI
Canta Ardealul si Banatul - Doine - EMIL GAVRIS
Invatatorii de Grija - Sanziana, fata Soarelui - ALEX DONOVICI
Razboiul unei familii 1914 - 2014 - STEPHANE AUDOIN-ROUZEAU
Caderea intru inaltare - RICHARD ROHR
Aventuri din padure - Amintirile Cartitei Mark - MICKAEL BRUN-ARNAUD
Metodele secrete ale lui Hermes - ASTRONIN ASTROFILUS
Micul Mare Excavator - O calatorie incredibila - SEBASTIAN HORN
Prima mea carte de activitati Montessori. La grupa mica - N/A
Pachet Raspundel Istetel - Primele mele forme si culori - N/A
Album - Tracing memory - VLAD BASARAB
Demografia Romaniei in perioada postbelica - TRAIAN ROTARIU
(Ne)facuti unul pentru celalalt - MEGHAN QUINN
Beethoven - Piese mici pentru pian - LUDWIG VAN BEETHOVEN
Alfabetul - Puzzle educativ 100 de piese - N/A
Unde cresc biscuitii? - SVETLANA TATARNIKOVA
Avertisment - Poate contine urme de alune - JOHN O'FARRELL
Aspecte ale feminitatii in literatura romana - LAURA ELENA UDUDEC
Povesti cu statui si fantani din Bucuresti - VICTORIA DRAGU-DIMITRIU
Tigrul nerecunoscator - Povesti asiatice - STEFAN LIICEANU
Muzica pentru cameleoni - Vinil - TRUMAN CAPOTE
Asociatia de proprietari - Presedintele asociatiei - GELU GABRIEL PUSCAS
Ce vad ochisorii mei? Cauta si gaseste cu Montessori - CHARLINE PICARD
Securitatea 1948-1989. Volumul I - FLORIAN BANU
Supermasini si sunetele lor - Carte cu sunete - A.C. PINNINGTON
Bricolaj - Ghid complet - N/A
Hai sa coloram! Volumul 4 - JORDI BUSQUETS
Amantele trecutului. Secret - ALEXANDRA GHEORGHE
Abtibilduri metalice - Roboti - BEN NEWMAN
Stresul ‚Äì explicatii, implicatii, aplicatii - COSA LUCICA EMILIA
Siesta cu poetul - boa - CRISTIAN BADILITA
Detaliul Secession - Timisoara - MIHAI-CLAUDIU MOLDOVAN
Athos - Arhitectura si spatiu sacru - TEOFIL MIHAILESCU
Brentano - Comte - Mill: ideea filosofiei ca stiinta - ION TANASESCU
Aventurile lui Sinbad Marinarul - BOLES≈ÅAW LESMIAN
Rolul parteneriatelor interinstitutionale in cadrul guvernantei europene - ALBERT-ANDREI CRAIU
Secretele Lui Colin Powell - OREN HARARI
Opere - 2 volume - SERBAN CIOCULESCU
Nicolae Manolescu. (Pre)istoria criticului - MARIAN VICTOR BUCIU
Comunicarea de la origini la internet - N/A
33+3 - Poemele copilariei - HANNA BOTA
Calatoria unui fiu risipitor. Eseu romantat asupra neizbinzii - NICOLAE STEINHARDT
Galben - Povestea unei culori captivante - MICHEL PASTOUREAU
Evaluarea impactului migratiei parintilor asupra comportamentului infractional al copiilor ramasi acasa - LOREDANA FLORENTINA CATARAU
Origini. Sfanta limba batrana a zimbri-getilor - GEORGE CADAR
Escape Room - Camera groazei - MAREN STOFFELS
Societatea secreta a animalelor - Renasterea Phoenixului - LUKE GAMBLE
Nikita Mihalkov: Strain printre ai tai - F. RAZZAKOV
Confesiunea unui nutritionist - VALENTIN VASILE
English Grammar - Theory and Practice - CONSTANTIN PAIDOS
Cum sa citesti o persoana in 3 minute - Morfofizionomie practica - ESTER PATRICIA CERESA
Lungul drum al noptii catre zi - Memorii - DINU GHIKA
O istorie culturala - Romii - BECKY TAYLOR
Niklas Luhmann - Schimbari de paradigma in teoria sistemelor - SCHUSTER CHRISTIAN
Formula sanatatii perfecte - Dieta alcalina - THEODORE A. BAROODY
Badea George - ultima zi / L'Onlce George - son dernier jour - MARIAN ILEA
De Bello Dacico - Volumul 2 - GABRIEL MARINESCU
Calm ecuatorial - Blestemul Casei Helmsley - NICHOLAS GANNON
Garfield Ia Proportii - JIM DAVIS
Dictionar drept, economie, afaceri - MEZEI JOZSEF
Repere ale politicii stiintei in Romania - Perspectiva unui economist - VALENTIN COJANU
Pachet - Trilogia Danzigului - GUNTER GRASS
(In)corect / Vrabia - LETA POPESCU
Mihai Sora - Omul dialogal - LEONID DRAGOMIR
Povestile copilariei - Frumoasa din padurea adormita - CHARLES PERRAULT
Vechi locuri si zidiri iesene. Volumul I - ION MITICAN
Desculta in Amazon - LUMINITA CUNA
23 August 1944. Legende si adevar - Controverse si evaluari - GAVRIIL PREDA
Nicolae Manolescu-70 - LEFTER ION BOGDAN, VLASIE CALIN
Sindromul de exaltare in Sud-Estul Noii Europe - Volumul 2 - NICOLAE SUCIU
Lumea-n gama martiana - Juniorii - FLORENTINA SAMIHAINA
Raspundel Istetel - Sa invatam cu povesti - N/A
Noua lege a pensiilor si Normele de aplicare - N/A
Opt sute de leghe pe Amazon - JULES VERNE
In Lumea Culorilor - Vulpita Mea - N/A
Revista romana de comunicare si relatii publice nr. 12 / 2008 - N/A
Inteligenta emotionala. Leadership autentic - BILL GEORGE
Concertul din padure - Editie bilingva Romana-Engleza - ADINA LATES
Primele mele cuvinte cu autocolante. Printese (engleza-romana) - N/A
Autobuzul energiei - Zece reguli pentru a-ti alimenta viata, munca si echipa cu energie pozitiva - JON GORDON
Limbajul secret al astrelor - GARY GOLDSCHNEIDER
Cumpana dintre noi - Editie trilingva - SILVIU MIHAILA
Limbajul poeziei scaldice - FLAVIA TEOC
Dinozauri - Mini-enciclopedie ilustrata - DIANA TAUTAN
Dinozaurii mei - ABC - LUISA ADAM
Antologia - Certitudinea - MIRON MANEGA
Versuri adunate, rime minunate - ABC - PETCU ABDULEA
Interpretarea ezoterica a unor basme si balade populare romanesti - VASILE LOVINESCU
Codul penal si Legea de punere in aplicare - 5 ianuarie 2021 - PETRUT CIOBANU
In Anzii Cordilieri - KARL MAY
Invitatie la psihoterapie prin dans si miscare - FLAVIA DORELIA CARDAS
KGB - Adevarata istorie a serviciilor secrete sovietice - BERNARD LECOMTE
Pachet cultura. Romani celebri - N/A
Umbra, polul intunecat al sufletului - ADRIAN NUTA
Persepolis - Volumul 1 - MARJANE SATRAPI
Po Po Ghici - Volumul 1 - ANA ELENA CAZBIR
Finante publice - modele de analiza si studii de caz - RADU TITUS MARINESCU
Leti si Luca. A venit primavara - RUTH WIELOCKX
Cum sa devii mai bogat - Volumul 2 - RAYMOND BEAN
Wise Guy - Lectii dintr-o viata - GUY KAWASAKI
Album Culoarul Rucar-Bran - N/A
Viata ii dauneaza grav sanatatii - VICTOR
Claude - Volumele 1-3 - ALEX T. SMITH
Zece mesaje pe care ingerii tai doresc sa le cunosti - DOREEN VIRTUE
Cum sa faci bani - Volumul 1 - RAYMOND BEAN
Ghid practic Excel pentru elevi - N/A
Plansa - Tipuri de ecosisteme - FLORICA ALEXANDRESCU
Greata, Cuvintele - JEAN-PAUL SARTRE
Despre binefaceri - Binele tau e al meu - LUCIUS ANNAEUS SENECA
Transportul rutier al marfurilor periculoase - ADR - MARIUS TEODORESCU
Vindecarea energetica - Pe intelesul tuturor - ABBY WYNNE
Rasismul si intoleranta - LOUISE SPILSBURY
Caii - Uriasii domestici - CAPUCINE MAZILLE
Tabi - Tablita multifunctionala A4 cu accesorii magnetice - N/A
Logopedie prin jocuri si exercitii - LAURA HARDALAU
In honorem Valeriu Stoica - MARIAN NICOLAE
FSN - Un paradox politic (1989-1992) - Volumul I cu CD - ANNE JUGANARU, ALEXANDRU RADU
Indrumator al cunoasterii prin stiinta si credinta - VALERIU POPA
Ghetsimani  æ51 - N/A
Craii de Curtea-Veche - Gallants of the Old Court - MATEIU I. CARAGIALE
Vasile Velisaratu - Catalog - LIANA AXINTE
Ginny Moon - Din secretele unei fetite autiste - GINNY MOON
Geneza - Marea poveste a originilor - GUIDO TONELLI
Vorbire - Dictiune sau Rostirea cuvantului romanesc - GEORGE V. GRIGORE
Nume de cod: Trandafirul - KATE QUINN
Secolul 21 - Ion Vianu, contemporanul nostru - N/A
Mini album - Monumente unesco romana-engleza - N/A
Biserici si manastiri ortodoxe din Romania - DVD - N/A
Primul Craciun al lui Sorichit - RIIKA JANTTI
Harta - Ungaria - N/A
Caderea din timp - O poveste pe mai multe voci - DAVID GROSSMAN
Clubul eroinelor - Inalta tradare la internat - NINA WEGER
Lucru manual - Animale din padure - AGNIESZKA NIEDZWIADEK
Asa a descoperit omul cainele - KONRAD LORENZ
Punguta cu doi bani. Carte de citit cu litere mari de tipar - N/A
Enciclopedia Pt.Copii - Convietuirea - LAROUSSE
Economie si cultura - Studii interdisciplinare - ALEXANDRA ZBUCHEA
Secretul Nebula - TRUDI TRUEIT
Beethoven - Marile epoci creatoare , Volumul VI - ROMAIN ROLLAND
Erst Dann - Abia atunci - JURGEN FUCHS
Universul - Ghid ilustrat complet - MARTIN REES
Disney Clasic - Megaplansa de colorat - N/A
Caiet pentru timpul liber si after school. Fise de invatare diferentiata pentru 5-6 ani - VALENTINA ILIESCU
Invazia extraterestrilor obezi - Jurnalul unei oi destepte. Volumul 2 - SABIN STAVARACHE
Evacuarea. O umbra peste Moisei - DRAGOMIR VLONGA
Lecturile Copilariei clasa a III-a - LUCICA BUZENCHI
Aproape totul despre Virgil Ierunca - ALEXANDRA FLORINA MANESCU
Cartea fantoma - Fuga - Drumul - VICTOR MARTIN
Creionel - caiet de exercitii grafice 3-4 ani - LAURENTIA CULEA
Umbra penei de gasca - RADU TUCULESCU
Set 4 carti - Sa calatorim in alte tari - FALCON MALDONADO
Despre feluritele metode de traducere - FRIEDRICH DANIEL
Cand literatura comparata pretinde ca se destrama - Studii si eseuri Vol. 1 - NICOLETA POPA BLANARIU
Pe bune - De tot rahatul - HARRY G. FRANKFURT
Tristetea - Dans / Tristeza feita danca - VIN√çCIUS DE MORAES
Design pentru lumea reala - VICTOR PAPANEK
Violetta. Jurnal de vacanta - N/A
Paula si o aniversare de neuitat - Nivel III - KATJA REIDER
Pachet Tetralogia Napolitana - 4 volume - ELENA FERRANTE
Hexagonale - VASILE SPIRIDON
Legea lui Dumnezeu ‚Äì Istoria filosofica a unui legamant - REMI BRAGUE
Formele muzicale ale Barocului in operele lui J.S. Bach - Album pentru Anna Magdalena Bach - SIGISMUND TODUTA
Domnisoara Goth si festinul cel sinistru - CHRIS RIDDELL
Umbra de ploaie - Ombra di pioggia - CAMELIA IONITA MIKESCH
Vasko Popa - O Frontiera Poetica - LIUBITA RAICHICI
Opere I. Didona, regina Cartaginei - Masacrul de la Paris - CHRISTOPHER MARLOWE
Iepurele si Ursoaica - Pacostea din cuib - JULIAN GOUGH
Tifi Papadie - O noapte fantomatica la gradinita - ANDREAS H. SCHMACHTL
Introducere in diplomatia digitala - CRISTINA BODONI
Ocolul Pamantului in sapte luni si o zi. Volumul I - Egiptul - GENERAL C. GAVANESCUL
Cartea Secreta A Trolilor - DANNY WILLIS
Intoarcere la Cumpana apelor - ELIZABETH KAYE
Atlas Zoologic General - CONSTANTIN BOGOESCU »òI AL»öII...
Supa de la miezul noptii - MARTA PETREU
Carte Surpriza - Leul Mananca Laptuci - SONIA CANALS
Anatomia ambiguitatii - DENISA BADEA
Legislatia transporturilor. Indrumar practic - ANDREEA-TEODORA STANESCU
Revista INSHR-EW Vol VI, Nr. 1 (7)/2014 - N/A
Manual de supravietuire in cancerul mamar - JOHN WEST
Biserica Ortodoxa Copta - Un miracol al istoriei - TADROS Y.MALATY
Cand copilasii sunt obositi - KATJA REIDER
Antonimele - Prima mea carte de invatatura - LUCIA TURCANU
Codul penal: octombrie 2018 - DAN LUPASCU
Ramai vesnic vrajitoare‚Ä¶ - Cand esti vrajitoare... Vol. 2 - CAROLYN MACCULLOUGH
Marturii de istorie si cultura romaneasca - II - MARIANA LAZAR
Noapte buna, Magarusule! - VERONIQUE CAUCHY
Carte de activitati - Mijloace de transport - ALAIN GREE
Drept civil - Teoria generala a obligatiilor - EMOD VERESS
Singuratatea lui Adam - CLAUDIU SOARE
Epitete alchimice - Hipotipoza la Mutus Liber - PIERRE DUJOLS
Sin City - Un adio tarziu - FRANK MILLER
Romania postcomunista - Istorie si istoriografie - OVIDIU PECICAN
Slava lui Dumnezeu. O estetica teologica - Volumul II - HANS URS VON BALTHASAR
Domnisoara Mimi si ursuletul Bran - ADRIANA MITU
Jurnalul unui bebelus - DANIEL N. STERN
Dictionar neconventional al scriitorilor si publicistilor evrei - 2 volume - TESU SOLOMOVICI
Povestiri istorice - Volumul 1 - DUMITRU ALMAS
Radu Penciulescu si teatrul la inaltimea omului - 2 volume - FLORICA ICHIM
Amor si galanterie bucuresteana - CORNELIU SENCHEA
Dumnezeu si Holocaustul la Elie Wiesel - SANDU FRUNZA
Securitatea 1948-1989. Volumul I - LIVIU TARANU
Afganistan - Invinsul neinvins - NATALIE AMIRI
7 Postmoderni: Nedelciu, Craciun, Muller, Petculescu, Gogea, Danilov, Ghiu - ION BOGDAN LEFTER
Imbratisatoarea - LAURA GRUNBERG
Heidegger si pariul Nimicului - MIHAIL TURCAN
Suprapuneri - Fotografie experimentala din anii 1970 - 1980 - STEFAN BERTALAN
Filosofia sexului - editie necenzurata - RADU F. CONSTANTINESCU
Ciclul vietii - O calatorie despre evolutia naturii - GABBY DAWNAY
Seasons Autumn - Volumul 4 - DESPINA CALAVREZO
Idei liberale in (pre)facerea Romaniei Mari - SABIN DANIEL DRAGULIN
Moartea ca o cocota de lux - AUREL CARASEL
Puterea fragilitatii - DOINA CORNEA
A manca sau a fi mancat - Riscul deciziei strategice in managementul modern - HOWARD H. STEVENSON
Ursul - Animale salbatice in natura - RENNE
Legendele Olimpului. Necyomantia - oracolul mortilor - GHEORGHE POPA-LISSEANU
Pachet - Descopar stiintele de mic - RUTH SPIRO
Capitala sub ocupatia dusmanului 1916-1918 - CONSTANTIN BACALBASA
Harry Potter - Almanah Vrajitoresc - J.K. ROWLING
Timisoara - Casele magice ale orasului - PETRU ILIESI
Istoria loviturilor de stat in romania - vol. II - ALEX MIHAI STOENESCU
Mi-a ramas dulapul mic - SIMONA SAVA
A compune dans. Arhitecturizare corporala - LIVIA TULBURE-GUNA
Coloram si ne jucam - Frumoasa si Bestia - DISNEY
Sfantul Ilarie de Poitiers - PHILIPPE HENNE
Cronicile spiderwick - Mallory sta de paza - BROOKE LINDNER
La inceput era cuvantul - Meditatii evanghelice duminicale, Volumul II - DIMITRIE BALAUR
O floare pentru iepuras - JOELLE TOURLONIAS
Pachet 3 volume - Sandman - NEIL GAIMAN
Zana - Vrajitoare - BIRGITTE MINNE
Citesc, rezolv, progresez - Clasa a II-a - STEFAN PACEARCA
Biblia pentru copii - Povestita de Parintele Necula - CONSTANTIN NECULA
Somnorosii verii - Animale care (hiberneaza) estiveaza - MELISSA STEWART
Eu, Odin si Vikingii Salbatici - FRANK SCHWIEGER
Bucuriile »ôi capcanele lecturii - MIRCEA GHEORGHE
Sir John Templeton - Sprijinirea cercetarii stiintifice pentru descoperiri spirituale - ROBERT L. HERRMANN
Romania - Editie bilingva: Romana-Engleza - DANA CIOLCA
In lift cu Einstein - JURGEN TEICHMANN
Povestile Diandrei - Volumul 1 - ION-OVIDIU PANISOARA
Cvartetul piatra - 4 Volume - GIUSEPPE MASAVO
Ghid complet de tarot si ezoterism - vol 2 - NARAN GHESER
Ce-ar sti adica un poet despre viata - Carte + CD - DAN SOCIU
Amuleta - Volumul 3 - KAZU KIBUISHI
Remote - Biroul este optional - JASON FRIED
Medicina clinica - Chirurgie generala si specialitati chirurgicale - Sinopsis de medicina - Set 3 volume - PARVEEN KUMAR
Timisoara carolina - Geneza orasului premodern (1716-1740) - SANDRA CRISTINA HIRSCH
Integrala Peanuts - Volumul 1 - CHARLES SCHULZ
Cum sa-ti imblanzesti rebelul interior - PAULINE WALLIN
Cutremurul Mondial - Pachet 3 volume - SCARLETT THOMAS
Prima mea enciclopedie cu lucruri foarte importante - N/A
Procesul marii tradari nationale - Volumul 3 - MARCEL-DUMITRU CIUCA
Sonnets - Sonete - WILLIAM SHAKESPEARE
Prajituri in spatiu - PHILIP REEVE
Roma - Ghid de calatorie - DEAGOSTINI
Finante corporative - Evaluarea investitiilor directe si finantarea lor - ION STANCU
English Grammar Practice 2 - The Verb - LAURA ANTON
Aliatul inamic - ALEKSANDR N. VINOGRADSKI
Povestioare cu ploaie si soare - PASSIONARIA STOICESCU
Infernul - repovestita - DANTE ALIGHIERI
Ornamente din panglici pentru cadouri - Idei Creative 69 - N/A
Tricoul negru - JORGE ZEPEDA PATTERSON
Jose Mourinho. Sub lupa - ROBERT BEASLEY
Structuralismul / Calmul Valorilor - Opere I - VIRGIL NEMOIANU
Adio, Gulag - LEVAN BERDZENISVILI
Noua cetate a lui Dumnezeu. Volumul I - Calea - DUMITRU DRAGHICESCU
Viata vesnica a sufletului. Scrierile lui Seth - JANE ROBERTS
Anatomia omului - Aparatul locomotor - VICTOR PAPILIAN
Povestile bufnitei - Pisoiul care se temea de orice - ERIC-EMMANUEL SCHMITT
Gheorghe Simotta - Intre noblete si arhitectura - CORNEL SAMARA
Sss! Face elefantul - Bobi si Doddi - MICHAELA HOLZINGER
Cosmin. Von einem, der auszog, das Leben zu lernen / Povestea lui Cosmin care a plecat de acasa sa cunoasca viata - KARIN GUNDISCH
Haijindo - Calea Poetilor - CLELIA IFRIM
Ardere si izbavire - Horia Zilieru - PAUL GORBAN
Warcraft - Ultimul Gardian - JEFF GRUBB
Gavinies - Studii (Capricii) - GAVINIES
Poeti ai Clujului de azi - Poete ale Clujului de azi - CUBLESAN CONSTANTIN
Migratia elefantilor - Invat sa citesc Nivelul 4 - LAURA MARSH
Recunostinta (Editie bilingva Romana - Engleza) - FLORIN ZAMFIR
Mefisto sau Mastile care imbraca neantul - OFELIA MAGDALENA POPII
Spre Meka... - ALEXANDRU MACEDONSKI
Brand New - Viitorul chip al brandurilor - WALLY OLINS
250 de lucruri de incercat intr-o viata - pentru cupluri - ELISE DE RIJCK
Si se auzeau greierii - CORINA SABAU
Opere - Volumul 9 - DUMITRU TEPENEAG
Atlas scolar - Istoria romanilor - ELENA OPREAN
Originile si evolutia Uniunii Europene - DESMOND DINAN
Join us for English 1 - Activity Book - GUNTER GERNGROSS
Ajuta-ti copilul sa revina pe calea cea buna - KENNETH H. TALAN
Dictionar critic al psihologiei analitice jungiene - ANDREW SAMUELS
Paradiso - Paradisul - DANTE ALIGHIERI
Sunt o fata rebela - Jurnalul cu care incepe schimbarea - FRANCESCA CAVALLO
Sistemul endocrin al vitaminei D - Volumul 1 - DORU DEJICA
Gaseste-ma! Animale uimitoare - N/A
Ghid Turistic - Paris - GARRY MARCHANT, MARNIE MITCHELL
Giordano Bruno - SALVATORE PRINZI
Pasari decorative - N/A
Cantece de zgura - Antologie lirica - VALERIU CIOBANU
Mantra - Puterea sunetului sacru - SWAMI ATMANANDA
Cantece religioase - Imnuri catre noapte - NOVALIS
Alzheimer - Scurta perspectiva asupra unuia dintre cele mai mari mistere ale creierului - EVA ANCA HAMZA
Enciclopedia sefilor de stat si de guvern ai Romaniei - NICOLAE C. NICOLESCU
Elogiul moderatiei - AURELIAN CRAIUTU
Elena din Avalor - Cele mai bune surori. Caiet de activitati - DISNEY
Iertarea - Miraculoasa cheie divina - PETER HORROBIN
Povestea kendamei pierdute - ADINA ROSETTI
Bitcoin - 21 de lectii - GIGI
Quilling: decoratiuni moderne - Idei crative 110 - PATRICK KRAMER
Generatia o mie de semne - GELU DIACONU
Secolul 21 - Geta Bratescu - N/A
Basme. Volumul 1 - Eroi in exil - BILL WILLINGHAM
Dictionar enciclopedic Mihai Eminescu - MIHAI CIMPOI
Surasul lui Icar - Aforisme - VASILE GHICA
Dialoguri asupra religiei naturale - DAVID HUME
Cartea Mea de Colorat - cu Realitate Augmentata, 4D - N/A
Dependenta de computer, de jocuri, de nicotina - KONSTANTIN V. ZORIN
Metoda de violoncel - Volumul II - DIMITRIE GH. DINICU
Dictionar roman - german - E. SAVIN
Matemagia - Numere si alte enigme - STEVE WAY
Bone - Fuga din Boneville - JEFF SMITH
Comparatii si semnificatii - 544 de jetoane - GABRIELA GIRMACEA
Cand ingerii vegheaza - LEXI B. NEWMAN
Mapa Logico - Pregatiti pentru scoala. Priveste in jur, descopera si spune - N/A
Metarealia - N/A
Carmina Burana - Baladele in jargon si gibelina - KARL ORFF
Tai-Pan - 2 volume - JAMES CLAVELL
Eliberarea Fatmei - editie bilingva - WILHELM HAUFF
Corespondenta germana (1933-1936) - Deutsche Korrespondenz (1933-1936) - ANTON GOLOPENTIA
Managementul calitatii si sigurantei alimentului - ANDREI OCTAVIAN PARASCHIVESCU
Bulgaria - Harta turistica si rutiera - N/A
Jurnal cu tine, o lighioana si restul lumii - IOANA NEGOESCU
50 de metode de instruire pentru a facilita intelegerea unui text - DOUGLAS FISHER
E OK s-o dai in bara - N/A
Moartea lui O-Tsuya - JUNICHIRO TANIZAKI
Codul civil - Actualizat la 30.09.2024 - FLAVIUS-ANTONIU BAIAS
Ciudatul caz la hotului de coji de branza - vol 9 - GERONIMO STILTON
Ghidul incepatorului - Hello English! Editie Bilingva - SAM HUTCHINSON
Revista Secolul 21 - Doinas la o dubla comemorare - N/A
Tehnica in psihanaliza copilului - CLEOPATRE ATHANASSIOU - POPESCO
Un dulau si un arici la psihoterapie de cuplu - Volumul 2 - LAURA PANAZAN
In umbra epocilor - Obsesia - LORIAN CARSOCHIE
Calendarele poporului roman - Martie - ANTOANETA OLTEANU
Dan Vinci si mostenirea aproape geniala a lui Leonardo - S.B.B. BURNER
Carti mici pentru pici - ABC (Alfabet) - INESA TAUTU
Transilvania ≈üi locuitorii sai - Volumul II - AUGUSTE DE GERANDO
Traversand Ploestii. Volumul III - ALIN TOMOZEI
Ordinul Povestitorilor - Nr. 17 - N/A
Amintiri politice. Inceputul unei noi domnii - Volumul II - I. G. DUCA
Indragostitul cu o suta de chipuri - NICOLETA DABIJA
Superiepure - STEPHANIE BLAKE
Sarmanii bogati - JOKAI MOR
Generatia dopaminei - Cum sa gasim echilibrul intr-o lume a placerilor - ANNA LEMBKE
Arbitrajul - repere esentiale si practica arbitrala comentata - BOGDAN IONESCU
Dezvoltare personala - ABC - CAMELIA COMAN
Descult - Pavaj Proaspat Turnat - ION AGACI
Silvan - istoric in imagini al epocii sale - ADRIAN SILVAN IONESCU
Padurea Fermecata - Volumul 1 - ENID BLYTON
Arcade video games. Volumul I (Rusa / Engleza / Romana) - VLADIMIR NEVZOROV
Corticoterapia in practica medicala - N/A
Parenting fara stres in 12 pasi - CHRISTIANE KUTIK
Procedura insolventei. Partea generala. Practica judiciara - ANTOANELA CLAUDIA SUSANU
Singuratatea pietrelor - Theloneliness of Stones - Editie bilingva: Romana-Engleza - FLAVIUS LUCACEL
SoNoRo Conac - Album - N/A
ISIS. Jocul mortii - MARK BOURRIE
Puls - Manual de limba romana ca limba straina, Nivelurile A1-A2 - DANIELA KOHN
Intoarcere in Tibet - Un vis implinit / Return to Tibet - A dream Realised - ADRIAN ANGHELESCU
Scrieri - Publicistica social-politica - CONSTANTIN STERE
Turtita fermecata - N/A
Iuliu Barasch - Un iluminist evreu in Tara Romaneasca - IRINEL POPESCU
Opera dramatica - Volumul II - MATEI VISNIEC
George Ciprian - Omul, actorul, scriitorul - CRENGUTA GANSCA
Flash-uri din intamplari curgatoare - Jurnalul unui terapeut anonim - IOLANDA MITROFAN
Chei oculte in Codul lui da Vinci - ENRIQUE DE VICENTE
Bronz si Floarea-Soarelui - CAO WENXUAN
Rebeliune in marketing - MARK SCHAEFER
Pachet 3 carti - Vina, MƒÉ»ôtile fricii, Purgatoriul √Ængerilor - CAMELIA CAVADIA
Din Ulita Domneasca in ‚ÄûArcarie‚Äù - ION MITICAN
Livada - proiectare si ingrijire - PETER HIMMELHUBER
Istoria lumii 7650 - N/A
Primele lectii de pian - Opus 125 - ANTON DIABELLI
Porti din Brasov - Patrimoniul Discret - PETRA VLAD
Limba franceza - Gramatica si vocabular - IONUT PEPENEL
Stiintele educatiei - Dictionar Enciclopedic . Volumul 1 - EUGEN NOVEANU
Asterix si Cosorul de aur - RENE GOSCINNY
Gherasim Luca - Poezie Ontofonie - PETRE RAILEANU
Cea mai frumoasa noapte - Cea mai frumoasa zi - LIANA ALEXANDRU
Schumann - Album pentru tineret op. 68 - ROBERT SCHUMANN
Mihai Viteazul - O expunere sistematica si completa a luptelor sale - ANTON MOISIN
Bijuteriile mamei - DANA MOGA
50 de motive pentru care esti cel mai bun frate - N/A
Marketing. Proiecte si teste grila - COSTEL-IOAN CIOBAN
Geronimo Stilton - Furtul diamantului urias - GERONIMO STILTON
Usi inchise, plicuri deschise - IOSIF KIRALY
Regatul cetii si al furiei - SARAH J. MAAS
Marsul funebru al unei marionete CG 583 - pentru pian - CHARLES GOUNOD
Invatamintul superior in Romania - MONICA - ANETA TURTUREAN
Oceanul - Carte cu imagini pop-up - LUANA SCHIDU
Numaratoarea Inversa - 1945 - CHRIS WALLACE
Drept civil - Mostenirea - EMOD VERESS
Romania si liderii ei - 1989 - TEODOR BRATES
Conciliul de la Ferrara - Florenta (1438-1439) - VASILE ALEXANDRU BARBOLOVICI
Ingeriada - JUDITH MESZAROS
Gobbolino, pisoiul vrajitoarei - URSULA MORAY WILLIAMS
Cruciada Diviziei de Cremene. Cu tricolorul in Caucaz - FLORIAN BICHIR
Lipesc, colorez si invat - Cifre si socoteli - N/A
Lotta descopera lumea - Iarna - SANDRA GRIMM
Ufo - Umor - EMILIAN STRAINU
Pachet 8: Ceasul strigoilor - Volumele I+II - JACK HENSELEIT
Cand cumparatorul spune nu - TOM HOPKINS
Mapa flori - Imagini si jetoane - N/A
Diletantismul - Individul si omul colectivului - RUDOLF KASSNER
Litote - Expozitie Atelier - SORIN DUMITRESCU
Olandeza. Ghid de conversatie - N/A
Case cu consum rational de apa - LAURA ALLEN
Vei fi mereu prietenul meu - N/A
Opera integrala - Volumul IV - PLATON
Scrieri - Publicistica literara si filosofica - CONSTANTIN STERE
Pustiul binelui - Eseuri filosofice - HORIA V. PATRASCU
Judecatorul - ‚Äûgura a legii‚Äù sau jurisprudenta - sursa a dreptului? - DIANA DANISOR
Mi se spune capucin - DANIIL HARMS
M-am plictisit de PowerPoint - ANDY SZEKELY
Codul de procedura civila - Actualizat la 30.09.2024 - N/A
Vreau sa fiu inginer de roboti - ANNA CLAYBOURNE
Minidictionar vizual francez-roman - N/A
Cartea secreta a lui Mos Craciun - Intamplari de Craciun - ANGELIKA STUBNER
Jules Verne - Editii de colectie (5 carti) - JULES VERNE
Teodramatica, Volumul 1 - Prolegomene - HANS URS VON BALTHASAR
Cantecul Codrului - o carare spre sufletul omului - NICOLAE MURESAN
Revolutia ca spectacol. Insemnarile unui sociolog in perioada septembrie 1988 - iulie 1992 - SORIN M. RADULESCU
Borges - o viata - EDWIN WILLIAMSON
Decoratii acordate de presedintii Romaniei in perioada 1991 - 2019 - IOANA DRAGULIN
Patrula Catelusilor. La fel sau diferit? - N/A
Catalog Expozitie Tipoia (Mogosoaia) - N/A
Vlad Tepes - Dracula - MARIANA PASCARU
Biologie - Ghid de pregatire - Clasele IX-X - ADRIANA SIMONA POPESCU
Torte vii in Blocul Sovietic - PETR BLAZEK
Razboiul literelor - 6 povesti pentru copii de 6 ani - RADU SERBAN
Romania - Muntii Retezat, Patrimoniu Natural Mondial (romana / engleza) - DAN BALTEANU
Pedagogia Waldorf - O introducere critica - HEINER ULLRICH
Educatia - de la traditional la digital - IOAN C. TESU
Poesie - Poezii - PIER PAOLO PASOLINI
A51 - 51 Birouri de Arhitectura. Editie bilingva ( Romana - Engleza) - N/A
Lumea lui Dodo - Fac ordine in camera mea - CECILE MARBEHANT
Clubul exploratorilor Ursul polar - ALEX BELL
Drept penal. Partea speciala 2. Curs tematic Ed.7 - VALERIAN CIOCLEI
Bucluc & Balamuc - Volumul 2 - SARAH MLYNOWSKI
Investigarea omorului savarsit cu arme de foc - MARIN RUIU
Dumitru Tinu si adevarul - Volumul I. Iesirea din transee 1989-1995 - ANDREI TINU
Au fost si ei candva copii - Cuviosul David - ANA IACOV
Memorator greseli frecvente in limba engleza. Clasele V - VIII - DOINA JUVERDEANU
Ruleta ruseasca - DAVID CORN
Ce se intampla cu mine - pentru baieti - ALEX FRITH
Jurnal terapeutic - 365 de momente de reconectare cu tine - LAVINIA BRATU
Poptropica - Volumul 1 - JACK CHABERT
Paula ia lectii de balet - Nivel III - KATJA REIDER
Colesteatomul urechii medii - MIHAI »òI AL»öII...
Thompson & Thompson - Genetica medicala - N/A
Figurine din hartie motive de Craciun Ed. a II a - Idei Creative 34 - BIRGIT UTERMARCK
Introducere si comentariu la Sfanta Scriptura. Volumul IV - Literatura profetica - RAYMOND E. BROWN
Emotionel. Setul meu cu reguli de bune maniere - PETRA BOANTA
AI - de la idee la implementare - CATALIN VRABIE
Cantemir - Inorogul in lavirinthul nestiintii - LIGIA RUSCU
In sfarsit nefumator - ALLEN CARR
Formele muzicale ale barocului in operele lui J.S. Bach. Volumul III - Variatiunea, Rondoul - SIGISMUND TODUTA
Turneul celor cinci natiuni - ANDREI ZBIRNEA
Ghidul managerilor intelepti - JAMES MCGRATH
Summa theologica - Volumul 2 - TOMA DIN AQUINO
Calea samanului - Un ghid pentru putere si vindecare - MICHAEL HARNER
Vintila Horia - Exilatul din exil - MADALINA VIOLETA DARMINA
Calin Nemes. Povestea unui revolutionar - TIBERIU FARCAS
Istoria civilizatiilor in 1000 de obiecte - N/A
Enciclopedia Yoga - Hatha Yoga - ANDRE VAN LYSEBETH
Labirintul lui Pan - Labirintul faunului - GUILLERMO DEL TORO
Dictionar juridic roman-englez / englez-roman - ONORINA BOTEZAT
Sfanta Liturghie: Catehezele Papei Francisc - EMIL MORARU
Trasse in Carpati Orientali - N/A
Harriet spioneaza - LOUISE FITZHUGH
Basme de Ion Creanga - Vinyl - ION CREANGA
Quilling - flori si alte ornamente - Idei creative 100 - PINTER FERENCNE
Politic (in)corect. Despre Romania cu dragoste - MONICA TATOIU
Lumile lui Zagreus - de la drama sacra la reprezentatia teatrala - ADRIANA CLAUDIA CITEIA
Poems in prose/ Poeme in proza - Editie bilingva - OSCAR WILDE
Scurta istorie a Europei de la Pericle la Putin - SIMON JENKINS
Alimentatia, Volumul I - Oltenia - CATALIN ALEXA
Cei mai buni hamburgeri - IRIS OTTINGER
Album pentru pian - copii - C. GURLITT
Animale salbatice. Carte interactiva cu sunete - N/A
Istoria filosofiei contemporane - Volumul V - P.P. NEGULESCU
Peisaj infinit - Endless Landscape - IOAN SBARCIU
Spionii zilei Z - spionaj si contraspionaj - BEN MACINTYRE
Versuri adunate, rime minunate - Momente si persoane speciale - IZABELA CONSTANTIN
Carusel - 10 povestiri cu Luca - PAUL TUMANIAN
Liviu Ciulei - acasa si-n lume (3 volume) - N/A
Percy Jackson si Olimpienii - Volumul 1 - RICK RIORDAN
Tiroida disfunctionala - N/A
Intelepciunea calma - Di@loguri in cyberspace cu Robert Lazu - VIRGIL NEMOIANU
Anatomia omului - Atlas scolar - FLORINA TIBEA
Apelative onomastice - Dictionar - PETRU TOMEGA
Opere - Volumul 2 - NICOLAE BALCESCU
In cercul fiarei - Putina speranta - CEZARINA ANGHILAC
Proza romantica - Negru pe alb - CONSTANTIN NEGRUZZI
Cazul unui incendiu Art Nouveau - LIVIA BANU
N.E.O. - Volumul 1 - MICHEL BUSSI
Hierotypos - Teologia icoanei dupa Sfintii Parinti - GEORGIOS KORDIS
Ciocuspocus - Secretul bauturii fermecate - MAJA VON VOGEL
Fecioarele despletite - HORTENSIA PAPADAT-BENGESCU
Monstri imblanziti - Caiet de dezvoltare emotionala - LAUREN STOCKLY
Mahalale de patrimoniu - RUBELI ANA
Manualul - Antidepresiv la purtator - EPICTET
Picturi - Improvizatii pentru pian, Op. 87 - CARMEN PETRA-BASACOPOL
Penultimul vis - ANGELA BECERRA
Ursulet este trist - N/A
Gramatica aplicata a limbii ruse. Flexiunea nominala - GABRIEL-ANDREI STAN
Focul - Prietenul sau dusmanul oamenilor? - GEORGETA BURLACU
Dietetica - o noua filosofie de viata. Volumele I+II - LAVINIA BRATU
Povestile mele minunate - N/A
Lichidati-l pe Maresal - FLORIAN BICHIR
De la inceput - Volum 1 - NIKAYLA DEVIN
Iter in silvis - Volumul 1 - IOAN PETRU CULIANU
Raspundel Istetel: Poezii - Rime mici pentru pici - N/A
Madeline Finn si catelul bibliotecar - LISA PAPP
Masti detasabile. Animale - N/A
Minionii - Traiasca regele Bob! - LUCY ROSEN
Microeconomics - Theory and Tests - MARIA-CRISTINA STEFAN
Pippa si Pelle - Un leac pentru fiecare - DANIELA DRESCHER
Triodul explicat - MAKARIOS SIMONOPETRITUL
Al doilea sex - Set 2 volume - SIMONE DE BEAUVOIR
Raspunsuri la intrebari ale intelectualilor. Volumul II - TEOFAN ZAVORATUL
Copii grozavi - Zece calitati esentiale pentru o viata fericita - STANLEY I. GREENSPAN
Lift - editie bilingva - EDMONDO DE AMICIS
Stalin - Opera de arta totala - BORIS GROYS
Slava lui Dumnezeu. O estetica teologica - Volumul I - HANS URS VON BALTHASAR
Fat-Frumos cand era mic - OCTAV PANCU-IASI
Minionii - Drumul catre Congresul Ticalosilor - TREY KING
Ariciul curios - in padure - CAMELIA ION
Mickey si pilotii de curse - Ma joc si descopar, Caiet de activitati - N/A
Zapada era murdara - GEORGES SIMENON
GDPR pentru afaceri - Un ghid eficient pentru companii - ELENA GRECU
Tara lui Putin - O calatorie in Rusia reala - ANNE GARRELS
Arta din pixeli - N/A
Bazele managementului - Paradigma sistemica - VADIM DUMITRASCU
Jurnalul unui caine poznas - MIROSiune imposibila - JAMES PETTERSON
Tratamentul tulburarii de anxietate generalizata - GAVIN ANDREWS
Sinaia - format mic - GEORGE AVANU
Legislatia asociatiilor de proprietari (Octombrie 2024) - N/A
Ghid de analiza grafica si grafologie - MIHAI CONSTANTIN DIANU
Vasile Cosma - Actor sub zodia Shakespeare - ALEXANDRU FIRESCU
Unicornul fermecat. Activitati de Craciun - N/A
1924 - Razboiul care a tinut trei zile - ANDREI TIGANAS
Tilda Soricela - Calatorie fascinanta in jurul lumii - ANDREAS H. SCHMACHTL
Iliada - Repovestire dupa epopeea lui Homer - HOMER
Limba moderna 1 - Engleza. Caiet de lucru pentru clasa a V-a - LILIANA PUTINEI
Politica Romaniei fata de Problema Palestiniana 1948-1979 - CRISTINA NEDELCU
Codul muncii - Vol 1+2 - COSTEL GILCA
De vorba cu parintii - Ghid Catehetic - PINO MARELLI
Plansa legume/fructe plastifiata fata/verso 50/70cm cu agatatoare - N/A
Gradina cu ierburi miraculoase - LAURA ZANETTI
Ioan Petru Culianu - Ipostazele unui eretic - RAUL POPESCU
Romanii din Muntii Apuseni (Motii) - TEOFIL FRANCU
Metoda. Volumul III - Cunoasterea cunoasterii - EDGAR MORIN
Teste rezolvate de Religie Ortodoxa pentru reusita examenul de definitivare - ALIN ILIE BIRSAN
The Cuphead Show! - Volumul 1 - N/A
Rezilienta si manifestari clinice in comportamentul persoanelor izolate, disparute, retinute sau capturate - VASILE MARINEANU
Skin - Volumul 2 - ANDREA FOWLER
Accesorii noi din jeansi vechi - Idei creative nr. 129 - GARA MARI
Ciprian Porumbescu - Jurnal 1879 - CIPRIAN PORUMBESCU
Regatul flacarilor argintii - SARAH J. MAAS
Miscarea Romana de Rezistenta din Mehedinti (1949-1952) - N/A
Cainii si pisicile - Prietenii omului - EMILIE VANVOLSEM
Imparatia soriceilor-strajeri - GABRIELA IONITA
Bioterorism, arme biologice si structurile de aplicare a legii - ADRIAN MIRCEA BACIU
Spete pentru admiterea la INM/magistratura. Drept civil si drept procesual civil - 2023 - VASILE BOZESAN
Orbitor. Aripa stanga - MIRCEA CARTARESCU
Degustatoarele - ROSELLA POSTORINO
Manual de anestezie si terapie intensiva - Anestezie - GABRIEL M. GURMAN
FIRICEL - Povestea unui soricel salvat de prieteni mici - ANDREA SCHOMBURG
Nastere naturala usoara - set de cartonase educative - CRISTINA INDRECAN
Feminin - Masculin - ALINA HURUBEAN
Roman Cotosman - Diet Sayler. An Artist Friendship - N/A
Cum supravietuieste monarhia intr-o republica? - ALEXANDRU MURARU
Revista Secolul 21 - Scoala sociologica de la Bucuresti - SANDRA GALOPENTIA
Investigatii in paranormal - Reteaua energetica a Pamantului - BRUCE L.CATHIE
Faptele apocrife ale apostolilor Petru, Pavel, Ioan, Andrei si Toma - N/A
China. O prezentare ilustrata - LI XUEMEI
Ascolta la Ciociaria / Asculta Ciociaria. Creatura celeste / Creatura celesta - LIBERO DE LIBERO
Legenda unei sinucideri - DAVID VANN
Shine - EDWARD M. HALLOWELL
Parinti implicati - parintii si copii invata impreuna - GARRY BURNETT
Fauritorul - Fictiuni - Memoria lui Shakespeare - JORGE LUIS BORGES
Povesti - Cartea intai - ION CREANGA
Biblia - format 073, grena - N/A
Povesti piezise de la Scoala-n Dunga - LOUIS SACHAR
Despre vietile si doctrinele filozofilor - DIOGENES LAERTIOS
Viata, Paraclisul si Acatistul Sfantului Ioan cel Milostiv - ION ANDREI TARLESCU
Contractele speciale - Sinteze teoretice, teste-grila si spete - FLORIN MOTIU
Revista - Terapie de basm nr. 6 - N/A
Strategii pentru propria securitate - EVY POUMPOURAS
Ars expectandi - Volumul 2 - MAGDA URSACHE
Grilajul din fereastra - DAN BITUICA
Istoria cladirii Academiei Romane - la 120 de ani - NICOLAE ST. NOICA
Aviatoarele - Aviatrices - SANDRA SANADA
Povesti - Cartea intai - ION CREANGA
Biblia - format 073, grena - N/A
Povesti piezise de la Scoala-n Dunga - LOUIS SACHAR
Despre vietile si doctrinele filozofilor - DIOGENES LAERTIOS
Viata, Paraclisul si Acatistul Sfantului Ioan cel Milostiv - ION ANDREI TARLESCU
Contractele speciale - Sinteze teoretice, teste-grila si spete - FLORIN MOTIU
Revista - Terapie de basm nr. 6 - N/A
Strategii pentru propria securitate - EVY POUMPOURAS
Ars expectandi - Volumul 2 - MAGDA URSACHE
Grilajul din fereastra - DAN BITUICA
Istoria cladirii Academiei Romane - la 120 de ani - NICOLAE ST. NOICA
Aviatoarele - Aviatrices - SANDRA SANADA
